11111111
10010P01
10001101
10100001 azerty	
1E11C111
11111111
