1111111111111111111111111111111111
1000000000000000000000000000000001
1000000000000000000000000000000001
1000000000001110000011111110000001
1000000000011100000111111111000001
1000000000111000000110000111000001
1000000001110000000000001110000001
1000000011100000E00000011100000001
1000000011100000000000111000000001
1000001110000110000001110000000001
1000011111111111100011100000000001
1000011111111111100111111111000001
1000000000000110000111111111000001
1000000000000000000000000000000001
1000000000000P0000C000000000000001
1111111111111111111111111111111111
