          11111111
          10C1EPC1
          10001101
          1C100001
          11111111

  
