

    
          11111111         
          10C1E0C1         
          1000C101         
          1C100001                    
          11111111    

  
