1111111111111111111111111111111111
1000000000000000000000000000000001
1000000000000000000000000000000001
1000000000001100000011111110000001
1000000000011100000111111111000001
1000000000111000000110000111000001
1000000001110000000000001110000001
1000000011100000E00000011100000001
1000000111000000000000111000000001
1000001110011000000001110000000001
1000011111111100000011100000000001
1000011111111100000111111111000001
1000000000011000000111111111000001
1000000000000000000000000000000001
1000000000000P0000C000000000000001
1111111111111111111111111111111111
