11111111
1G010P01
10001101
10100C01
1C11E111
11111111
