1111111111111111111111111111111111
1G00000000000000000000000000000001
1000000000000000000000000000000001
100000G0000011000000111111100G0001
10G0000000011100000111111111000001
1000000000111000000110000111000001
1000000001110000000000001110000001
1000000011100000E00000011100000001
1000000111000000000000111000000001
100000111001100G000001110000000001
1000011111111100000011100000000001
1000011111111100000111111111000001
100000000001100000011111111100G001
10000000000000000G0000000000000001
1G00000000000P0000C0000000000000G1
1111111111111111111111111111111111
