11111111
10010P01
10001101
10100001
1E110111
11111111
