11111111
10010P01
10001101
10100001
011C1E11
11111111
