11111111111111111111111111111111111111111111111111111111111111111111111111111111111111111111111111111111111111111111111111111111111111111111111111111111111
1E000000100000000000000000011000000000000001110000000000000000011111000000000000100000000001100000000001110000000000000111100000000000000111110000000000001
10000000000000000000000000000000000000000000000000000000000000000000000000000000000000000000000000000000000000000000000000000000000000000000000000000000001
10000000000000000000000000000000000000000000000000000000000000000000000000000000000000000000000000000000000000000000000000000000000000000000000000000000001
10000000000000000C000000000000000000000000000000000000C000000000000000000000000000000C00000000000000000000000000C0000000000000000000000000000000000C0000001
10000000000000000000000000000000000000000000000000000000000000000000000000000000000000000000000000000000000000000000000000000000000000000000000000000000001
10000000000000000000000000000000000000000000000000000000000000000000000000000000000000000000000000000000000000000000000000000000000000000000000000000000001
1000000010000000000000000001100000000000000111GGGGGGGGGGG00000011111000000000000100000000001100000000001110000000000000111100000000000000111110000000000001
1000000000000000000000000000000000000000000000GGGGGGGGGGG00000000000000000000000000000000000000000000000000000000000000000000000000000000000000000000000001
1000000000000000000000000000000000000000000000GGGGGGGGGGG00000000000000000000000000000000000000000000000000000000000000000000000000000000000000000000000001
1000C000000000000000000000000000000C0000000000GGGGGGGGGGG0000000000000000C00000000000000000000000C0000000000000000000000000000000C0000000000000000000000001
100000000000000000G0000000000000000000000000000000000000000000000000000000000000000000000000000000000000000000000000000000000000000000000000000000000000001
10000000000000000000000000000000000000000000000000000000000000000000000000000000000000000000000000000000000000000000000000000000000000000000000000000000001
10000000100000000000000000011000000000000001110000000000000000011111000000000000100000000001100000000001110000000000000111100000000000000111110000000000001
10000000000000000000000000000000000000000000000000000000000000000000000000000000000000000000000000000000000000000000000000000000000000000000000000000000001
10000000000000000000000000000000000000000000000000000000000000000000000000000000000000000000000000000000000000000000000000000000000000000000000000000000001
10000000000000000C000000000000000000000000000000000000C000000000000000000000000000000C00000000000000000000000000C0000000000000000000000000000000000C0000001
10000000000000000000000000000000000000000000000000000000000000000000000000000000000000000000000000000000000000000000000000000000000000000000000000000000001
10000000000000000000000000000000000000000000000000000000000000000000000000000000000000000000000000000000000000000000000000000000000000000000000000000000001
1000000010000000000000000001100000000000000111GGGGGGGGGGG00000011111000000000000100000000001100000000001110000000000000111100000000000000111110000000000001
1000000000000000000000000000000000000000000000GGGGGGGGGGG00000000000000000000000000000000000000000000000000000000000000000000000000000000000000000000000001
1000000000000000000000000000000000000000000000GGGGGGGGGGG00000000000000G00000000000000000000000000000000000000000000000000000000000000000000000000000000001
1000C000000000000000000000000000000C0000000000GGGGGGGGGGG0000000000000000C00000000000000000000000C0000000000000000000000000000000C0000000000000000000000001
1000000000000000000000000000000000000000000000GGGGGGGGGGG00000000000000000000000000000000000000000000000000000000000000000000000000000000000000000000000001
10000000000000000000000000000000G0000000000000GGGGGGGGGGG00000000000000000000000000000000000000000000000000000000000000000000000000000000000000000000000001
1000000010000000000G00000001100000000000000111GGGGGGGGGGG00000011111000000000000100000000001100000000001110000000000000111100000000000000111110000000000001
10000000000000000000000000000000P00000000000000000000000000000000000000000000000000000000000000000000000000000000000000000000000000000000000000000000000001
10000000000000000000000000000000000000000000000000000000000000000000000000000000000000000000000000000000000000000000000000000000000000000000000000000000001
10000000000000000C00000000000000G000000000000000000000C000000000000000000000000000000C00000000000000000000000000C0000000000000000000000000000000000C0000001
10000000000000000000000000000000000000000000000000000000000000000000000000000000000000000000000000000000000000000000000000000000000000000000000000000000001
10000000000000000000000000000000000000000000000000000000000000000000000000000000000000000000000000000000000000000000000000000000000000000000000000000000001
10000000100000000000000000011000000000000001110000000000000000011111000000000000100000000001100000000001110000000000000111100000000000000111110000000000001
10000000000000000000000000000000000000000000000000000000000000000000000000000000000000000000000000000000000000000000000000000000000000000000000000000000001
100000000000000000000000000000000000000000000000000000000000000000000000G0000000000000000000000000000000000000000000000000000000000000000000000000000000001
1000C000000000000000000000000000000C0000000000000000000000000000000000000C00000000000000000000000C0000000000000000000000000000000C0000000000000000000000001
10000000000000000000000000000000000000000000000000000000000000000000000000000000000000000000000000000000000000000000000000000000000000000000000000000000001
10000000000000000000000000000000000000000000000000000000000000000000000000000000000000000000000000000000000000000000000000000000000000000000000000000000001
10000000100000000000000000011000000000000001110000000000000000011111000000000000100000000001100000000001110000000000000111100000000000000111110000000000001
10000000000000000000000000000000000000000000000000000000000000000000000000000000000000000000000000000000000000000000000000000000000000000000000000000000001
10000000000000000000000000000000000000000000000000000000000000000000000000000000000000000000000000000000000000000000000000000000000000000000000000000000001
10000000000000000C000000000000000000000000000000000000C000000000000000000000000000000C00000000000000000000000000C0000000000000000000000000000000000C0000001
10000000000000000000000000000000000000000000000000000000000000000000000000000000000000000000000000000000000000000000000000000000000000000000000000000000001
10000000000000000000000000000000000000000000000000000000000000000000000000000000000000000000000000000000000000000000000000000000000000000000000000000000001
10000000100000000000000000011000000000000001110000000000000000011111000000000000100000000001100000000001110000000000000111100000000000000111110000000000001
10000000000000000000000000000000000000000000000000000000000000000000000000000000000000000000000000000000000000000000000000000000000000000000000000000000001
10000000000000000000000000000000000000000000000000000000000000000000000000000000000G0000000000G000000000000000000000000000000000000000000000000000000000001
1000C000000000000000000000000000000C0000000000000000000000000000000000000C00000000000000000000000C0000000000000000000000000000000C0000000000000000000000001
10000000000000000000000000000000000000000000000000000000000000000000000000000000000000000000000000000000000000000000000000000000000000000000000000000000001
10000000000000000000000000000000000000000000000000000000000000000000000000000000000000000000000000000000000000000000000000000000000000000000000000000000001
10000000100000000000000000011000000000000001110000000000000000011111000000000000100000000001100000000001110000000000000111100000000000000111110000000000001
100000000000000000000000000000000000000000000000G0000000000000000000000000000000000000000000000000000000000000000000000000000000000000000000000000000000001
10000000000000000000000000000000000000000000000000000000000000000000000000000000000000000000000000000000000000000000000000000000000000000000000000000000001
10000000000000000C000000000000000000000000000000000000C000000000000000000000000000000C00000000000000000000000000C0000000000000000000000000000000000C0000001
10000000000000000000000000000000000000000000000000000000000000000000000000000000000000000000000000000000000000000000000000000000000000000000000000000000001
10000000000000000000000000000000000000000000000000000000000000000000000000000000000000000000000000000000000000000000000000000000000000000000000000000000001
10000000100000000000000000011000000000000001110000000000000000011111000000000000100000000001100000000001110000000000000111100000000000000111110000000000001
100000000000000000000000000000000G0000000000000000000000000000000000000000000000000000000000000000000000000000000000000000000000000000000000000000000000001
10000000000000000000000000000000000000000000000000000000000000000000000000000000000000000000000000000000000000000000000000000000000000000000000000000000001
1000C000000000000000000000000000000C0000000000000000000000000000000000000C00000000000000000000000C0000000000000000000000000000000C0000000000000000000000001
10000000000000000000000000000000000000000000000000000000000000000000000000000000000000000000000000000000000000000000000000000000000000000000000000000000001
10000000000000000000000000000000000000000000000000000000000000000000000000000000000000000000000000000000000000000000000000000000000000000000000000000000001
10000000100000000000000000011000000000000001110000000000000000011111000000000000100000000001100000000001110000000000000111100000000000000111110000000000001
100000000000G0000000000000000000000000000000000000000000000000000000000000000000000000000000000000000000000000000000000000000000000000000000000000000000001
10000000000000000000000000000000000000000000000000000000000000000000000000000000000000000000000000000000000000000000000000000000000000000000000000000000001
10000000000000000C000000000000000000000000000000000000C000000000000000000000000000000C00000000000000000000000000C0000000000000000000000000000000000C0000001
10000000000000000000000000000000000000000000000000000000000000000000000000000000000000000000000000000000000000000000000000000000000000000000000000000000001
1000000000000000000000000000000000000000000000000000000000000000000000000000000000G000000000000000000000000000000000000000000000000000000000000000000000001
10000000100000000000000000011000000000000001110000000000000000011111000000000000100000000001100000000001110000000000000111100000000000000111110000000000001
10000000000000000000000000000000000000000000000000000000000000000000000000000000000000000000000000000000000000000000000000000000000000000000000000000000001
10000000000000000000000000000000000000000000000000000000000000000000000000000000000000000000000000000000000000000000000000000000000000000000000000000000001
1000C000000000000000000000000000000C0000000000000000000000000000000000000C00000000000000000000000C0000000000000000000000000000000C0000000000000000000000001
10000000000000000000000000000000000000000000000000000000000000000000000000000000000000000000000000000000000000000000000000000000000000000000000000000000001
10000000000000000000000000000000000000000000000000000000000000000000000000000000000000000000000000000000000000000000000000000000000000000000000000000000001
10000000100000000000000000011000000000000001110000000000000000011111000000000000100000000001100000000001110000000000000111100000000000000111110000000000001
10000000000000000000000000000000000000000000000000000000000000000000000000000000000000000000000000000000000000000000000000000000000000000000000000000000001
10000000000000000000000000000000000000000000000000000000000000000000000000000000000000000000000000000000000000000000000000000000000000000000000000000000001
10000000000000000C000000000000000000000000000000000000C000000000000000000000000000000C00000000000000000000000000C0000000000000000000000000000000000C0000001
10000000000000000000000000000000000000000000000000000000000000000000000000000000000000000000000000000000000000000000000000000000000000000000000000000000001
10000000000000000000000000000000000000000000000000000000000000000000000000000000000000000000000000000000000000000000000000000000000000000000000000000000001
10000000100000000000000000011000000000000001110000000000000000011111000000000000100000000001100000000001110000000000000111100000000000000111110000000000001
10000000000000000000000000000000000000000000000000000000000000000000000000000000000000000000000000000000000000000000000000000000000000000000000000000000001
10000000000000000000000000000000000000000000000000000000000000000000000000000000000000000000000000000000000000000000000000000000000000000000000000000000001
1000C000000000000000000000000000000C0000000000000000000000000000000000000C00000000000000000000000C0000000000000000000000000000000C0000000000000000000000001
10000000000000000000000000000000000000000000000000000000000000000000000000000000000000000000000000000000000000000000000000000000000000000000000000000000001
10000000000000000000000000000000000000000000000000000000000000000000000000000000000000000000000000000000000000000000000000000000000000000000000000000000001
11111111111111111111111111111111111111111111111111111111111111111111111111111111111111111111111111111111111111111111111111111111111111111111111111111111111
