11111111111111111111111111111111111111111111111111111111111111111111111111111111111111111111111111111111111111111111111111111111111111111111111111111111111
1EP000000001C0000000000000000000000000000000000000000000000000000000000000000000000000000000000000000000000000000000000000000000000000000000000000000000001
11111111110111111111111111111111111111111111111111111111111111111111111111111111111111111111111111111111111111111111111111111111111111111111111111111111101
100000000001C1000010000010000000010000000000000000000100000000000000000100000000000G000000G0000000000000000100000000000G000000G00000000G00000G0000000000101
10111111111100001000111010000000010000000000000000000100000000000000000100000000000G00000100000000000000000100000000000G000001G0000000000000100000000000101
1010000100C1011111111C00100000000000000000000000000001G0000000000000000100000000000G00000100000000000000000100000000000G000001G0000000000000100000000000101
10101101010100110100011110000000011111111110111111111100000000000000000100000000000000000100000000000000000100000000000000000100000000000000100000000000101
10101001010110000001000010000000010000000010000000000000000000000000000100000000000000000100000000000000000100000000000000000100000000000000100000000000101
10101011010110111111000010000000010000000011111111111100000000000000000100000000000000000100000000000000000100000000000000000100000000000000100000000000101
10101000010100000001000010000000010000000000000000000100000000000000000100000000000000000100000000000000000100000000000000000100000000000000100000000000101
1010111111010101110100000000000000000000000000000000010000GGGGG00000000100000000000000000100000000000000000100000000000000000100000000000000100000000000101
1010100000010101C10100001000000001000000000000000000010000GGGGG00000000100000000000000000100000000000000000100000000000000000100000000000000100000000000101
1010101111110101010100001000000001000000000000000000010000GGGGG000000001G0000000000000000100000000000G000001G0000000000000000100000000000000100000000000101
1000100000000100010000001000000001000000000000000000010000GGGGG000000001G0000000000000000100000000000G000001G0000000000000000100000000000000100000000000101
1111111111111111111111111011111111111111111111111111010000GGGGG000000001G0000000000000000100000000000G000001G0000000000000000100000000G00000100000000000101
1C000000000000000000000000100000000000000000000000000100000000000000000100000000000000000100000000000000000100000000000000000100000000000000100000000000101
11111111111111111111111111101011111111111111111111111100000000000000000100000000000000000100000000000000000100000000000000000100000000000000100000000000101
10001C00000000000000000000001000000000000000000000000100000000000000000100000000000000000100000000000000000100000000000000000100000000000000100000000000101
10101111111111111111111111111111111111111111111111110100000000000000000100000000000000000100000000000000000100000000000000000100000000000000100000000000101
1010000000000000000000000000000000000000000000000000010000000000000000000000000000000000010000000000000000000000000000000000010000000000000010000000000C101
10111111111111111111111111111111111111111111111111111111111111111111111111111111111111111111111111111111111111111111111111111111111111111110111111111111101
10100000000000001C0000000000000100000000000000000000000000000000000000000000000000000000000000000000000000000000000000000000000000000000001G000000G00000101
1010000000000000111111111111110100000000000000000000000000000000000000000000000000000000000000000000000000000000000000000000000000000000001G000001G00000101
10100000000000000G0G0G0G0000010100000000000000000000000000000000000000000000000000000000000000000000000000000000000000000000000000000000001G000001G00000101
101000000000000010G0G0G000000101000000000000000000000000000000000000000000000000000000000000000000000000000000000000000000000000000000000010000001000000101
10101111111111111G0G0G0G00000101000000000000000000000000000000000000000000000000000000000000000000000000000000000000000000000000000000000010000001000000101
101000000000000010G0G0G000000101GGGG00000000000000000000000000000000000000000000000000000000000000000000000000000000000000000000000000000010000001000000101
10100000000000001G0G0G0G00000101GGGG00000000000000000000000000000000000000000000000000000000000000000000000000000000000000000000000000000010000001000000101
10100000000000001000000000000101GGGG00000000000000000000000000000000000000000000000000000000000000000000000000000000000000000000000000000010000001000000101
10100000000000001000000000000101GGGG00000000000000000000000000000000000000000000000000000000000000000000000000000000000000000000000000000C10000001000000101
10100000000000001000000000000100000000000000000000000000000000000000000000000000000000000000000000000000000000000000000000000000000000000010000001000000101
10111111111111101000000000000111000000000000000000000000000000000000000000000000000000000000000000000000000000000000000000000000000000000010000001000000101
10100000000000001000000000000001000000000000000000000000000000000000000000000000000000000000000000000000000000000000000000000000000000000010000001000000101
10100000000000001000000000000001000000000000000000000000000000000000000000000000000000000000000000000000000000000000000000000000000000000010000001000000101
10100000000000001000000000000001000000000000000000000000000000000000000000000000000000000000000000000000000000000000000000000000000000000010000001000000101
10100000000000001000000000000001000000000000000000000000000000000000000000000000000000000000000000000000000000000000000000000000000000000010000001000000101
10100000000000001000000000000001000000000000000000000000000000000000000000000000000000000000000000000000000000000000000000000000000000000010000001000000101
10100000000000001000000000000001111111111011111111111111111111111111111101111111110111111111111111111101111111111111111111111111111111111111111111111110101
1010111111111111100000000000000100000000000000001G0G0G0G0G0G0G0G0G0G0G0G000001GGGGG000000GGGGG00000001GGGGGGGGGGGGGGGGGGGGG000GGGGGGGGGGGGGGGGGGG0000010101
10100000000000001000000000000001000000001000000010000000000000000000000000000100000000000000000000000100000000000000000000000000000000000000000000000010101
10100000000000001000000000000001000000001000000010000000000000000000000000000100000000000000000000000100000000000000000000000000000000000000000000000010101
10100000000000001000000000000001000000001000000010000000000000000000000000000100000000000000000000000100000000000000000000000000000000000000000000000010101
10100000000000001000000000000001000000001000000010000000000000000000000000000100000000000000000000000100000000000000000000000000000000000000000000000010101
10100000000000001000000000000001000000001000000010000000000C0000000000000000010000000000000C000000000100000000000000000000000000000000000000000000000000101
10100000000000001011111111111111011111111111111111111111111111111111111111111111111111111111111111111111111111111111111111111111111111111111111111111110101
10100000000000001000000000000000010C01C00000000000000000000000000000000000000000000000000000000000000000000000000000000000000000000000000000000000000000101
10111111111111101111111111111111111011111111111111111111111111111111111111111111111111111111111111111111111111111111111111111111111111111111111111111111101
1010G0G0G0G000001000000000000000000000000000000000000000000000000000100000000000000000000000000000000000000100000000000000000000000000000000000000000000101
101G0G0G0G0000001000000000000000000010000000000000000000000000000000100000000000000000000000000000000000000100000000000000000000001000000000000000000000101
1010G0G0G0G000001000000000000000000010000000000000000000000000000000100000000000000000000000000000000000000100000000000000000000001000000000000000000000101
10100000000000001000000000000000000010000000000000000000000000000000100000000000000000000000000000000000000100000000000000000000001000000000000000000000101
10100000000000001000000000000000000010000000000000000000000000000000100000000000000000000000000000000000000100000000000000000000001000000000000000000000101
10100000000000001000000000000000000010000000000000000000000000000000100000000000000000000000000000000000000100000000000000000000001000000000000000000000101
10100000000000001111111111111111111010000000000000000000000000000000100000000000000000000000000000000000000100000000000000000000001000000000000000000000101
10100000000000000000100000000000000010000000000000000000000000000000100000000000000000000000000000000000000100000000000000000000001000000000000000000000101
10100000000000000000101111111111111110000000000000000000000000000000100000000000000000000000000000000000000100000000000000000000001000000000000000000000101
10100000000000000000101000000000010000000000000000000000000000000000100000000000000000000000000000000000000100000000000000000000001000000000000000000000101
10100000000000000000101011111111010000000000000000000000000000000000100000000000000000000000000000000000000000000000000000000000001000000000000000000000101
10100000000000000000101010000001010000000000000000000000000000000000100000000000000000000000000000000000000100000000000000000000001000000000000000000000101
10100000000000000000101010111101010000000000000000000000000000000000100000000000000000000000000000000000000100000000000000000000001000000000000000000000101
101000000000000000001010101C0101010000000000000000000000000000000000100000000000000000000000000000000000000100000000000000000000001000000000000000000000101
10100000000000000000101010110101010000000000000000000000000000000000100000000000000000000000000000000000000100000000000000000000001000000000000000000000101
101000000000000000001010100001010100000000000000000000000000000000G010G000000000000000000000000000000000000100000000000000000000001000000000000000000000101
1010000000000000000010101111110101000000000000000000000000000000000G1G0000000000000000000000000000000000000100000000000000000000001000000000000000000000101
101000000000000000001010000000010100000000000000000000000000000000G010G000000000000000000000000000000000000100000000000000000000001000000000000000000000101
1010000000000000000010111111111101000000000000000000000000000000000G1G0000000000000000000000000000000000000100000000000000000000001000000000000000000000101
10100000000000000000100000000000010000000000000000000000000000000000000000000000000000000000000000000000000100000000000000000000001000000000000000000000101
10100000000000000000111111111111110000000000000000000000000000000000100000000000000000000000000000000000000100000000000000000000001000000000000000000000101
10100000000000000000000000000000000000000000000000000000000000000000100000000000000000000000000000000000000111111111111111111111111000000000000000000000101
10100000000000000000000000000000000000000000000000000000000000000000100000000000000000000000000000000000000100000000000000000000001000000000000000000000101
10100000000000000000000000000000000000000000000000000000000000000000100000000000000000000000000000000000000100000000000000000000001000000000000000000000101
10100000000000000000000000000000000000000000000000000000000000000000100000000000000000000000000000000000000100000000000000000000001000000000000000000000101
1010000000000000000000000000000000000000000000000000000000000000000010000000000000000000000000000000000000010000000000C000000000001000000000000000000000101
10100000000000000000000000000000000000000000000000000000000000000000111111111111111111111111111111111111111100000000000000000000001000000000000000000000101
1010000000000000000000000000000000000000000000000000000000000000000000000000000000000000000000000000000000000000000000000000000000100000000000000000000C101
10111111111111111111111111111111111111111111111111111111111111111111111111111111111111111111111111111111111111111111111111111111111111111111111111111111101
100000000000000000C0000000000000000000000000000000000000000000000000000000000000000000000000000000000000000000000000000000000000000000000000000000000000001
11111111111111111111111111111111111111111111111111111111111111111111111111111111111111111111111111111111111111111111111111111111111111111111111111111111111
