11111111
10010P01
10001101
10100001
1C110111
11111111
