11111111
10010001
10001101
10100001
1C11E111
11111111
