11111111
10010P01
10001101
10100001
111C1E11
11111011
