11011111
10010P01
10001101
10100001
1E11C111
11111111
