11111111
10010P01
10001101
10100001
1C11E1P1
11111111
